**XX*X*X*X*X**XX*XX*
X*XX*XXXX*XXXXXX**XX
X**XXXXXXXXX*XXXX*XX
XX**X*XXXXX*XXXXX**X
XXX*XX*XX*XXX*XXX*XX
****XXXX*XXXXX*XXX*X
*XXXXXX*XXXXXXX*XXXX
**********XXXXXXXXXX
XXXXXXXXX******XXXXX
X*XXX*XXX*XXXX*XXXXX
X*XXXXXXX*XXXX****XX
XX*XXXXXXXXXXXXXX**X
XXXXX*XX*XX*XXX*XX**
XXXXXX*XXXX*XXX*XXX*
X*XXXXXXXXXXXXXXXXX*
XXXX****************
X*XX*XXXXXXXXX*XXXXX
XXXX*XXXXXXXXXXX*XXX
X*XX****************
XXXXXXXXXXXXXXXXXXX*